RNNNNNNR
NYNNNNYN
NNGBBGNN
NYNNNNYN
RNNNNNNR