GNYNNYNG
NBNRRNBN
GNYGGYNG
NBNRRNBN
GNYNNYNG