NNGNNGNN
NNBNNBNN
NNNNNNNN
NYRNNRYN
NNYRRYNN